0000000000000000000000000
0000000000033300000000000
0000000000031300000000000
0000000000030300000000000
0000000000030300000000000
0000000000030300000000000
0000000000030300000000000
0000000000030300000000000
0000000000030300000000000
0000000000030300000000000
0000000000030300000000000
0000000000030300000000000
0000000000030300000000000
0000000000030300000000000
0000000000032300000000000
0000000000033300000000000
0000000000000000000000000
0000000000000000000000000
0000000000000000000000000
0000000000000000000000000
