0000000000000000000000000
0000000033300000000000000
0000000031300000000000000
0000000038300000000000000
0000000038333333330000000
0000000038388888830000000
0000000038383333830000000
0000000038383233830000000
0000000038883888830000000
0000000033333333330000000
0000000000000000000000000
0000000000000000000000000
0000000000000000000000000
0000000000000000000000000
0000000000000000000000000
0000000000000000000000000
0000000000000000000000000
0000000000000000000000000
0000000000000000000000000
