0000000000000000000000000
0333000000000000000000000
0313000000000000000000000
0303000000000000000000000
0303333333300000000000000
0303000000300000000000000
0303033330300000000000000
0303032330300000000000000
0300030000300000000000000
0333333333300000000000000
0000000000000000000000000
0000000000000000000000000
0000000000000000000000000
0000000000000000000000000
0000000000000000000000000
0000000000000000000000000
0000000000000000000000000
0000000000000000000000000
0000000000000000000000000
0000000000000000000000000
