0000000000000000000000000
0000000000000000000000000
0000000000000000000000000
0000000000000000000000000
0000000333333333300000000
0000000388888882300000000
0000000383333333300000000
0000000383888888300000000
0000000383833338300000000
0000000383831838300000000
0000000383833838300000000
0000000383888838300000000
0000000383333338300000000
0000000388888888300000000
0000000333333333300000000
0000000000000000000000000
0000000000000000000000000
0000000000000000000000000
0000000000000000000000000
