0000000000000000000000000
0000000000000000000000000
0000000000000000000000000
0000000000000000000000000
0000000333333333300000000
0000000300000002300000000
0000000303333333300000000
0000000303000000300000000
0000000303033330300000000
0000000303031030300000000
0000000303033030300000000
0000000303000030300000000
0000000303333330300000000
0000000300000000300000000
0000000333333333300000000
0000000000000000000000000
0000000000000000000000000
0000000000000000000000000
0000000000000000000000000
0000000000000000000000000
