0000000000000000000000000
0000000000000000000000000
0000000000000000000000000
0000003330000000000000000
0000003130000000000000000
0000003033300000000000000
0000003040300000000000000
0000003330333000000000000
0000000030403000000000000
0000000033303330000000000
0000000000304030000000000
0000000000333033300000000
0000000000003040300000000
0000000000003330300000000
0000000000000032300000000
0000000000000033300000000
0000000000000000000000000
0000000000000000000000000
0000000000000000000000000
