0000000000000000000000000
0333000000000000000000000
0313000000000000000000000
0303330000000000000000000
0304030000000000000000000
0333033300000000000000000
0003040300000000000000000
0003330333000000000000000
0000030403000000000000000
0000033303330000000000000
0000000304030000000000000
0000000333030000000000000
0000000003230000000000000
0000000003330000000000000
0000000000000000000000000
0000000000000000000000000
0000000000000000000000000
0000000000000000000000000
0000000000000000000000000
0000000000000000000000000
